. # . # . . . . . . # . # . . . . . # # . . . . # # . # # # # . . # # . # . # . . # # . . . . . . .
. . # . . # . . . . # . . . . . # # . . # . . # . . # . . . . # # . . # . . . . # . # # . . . . . #
. . . . . # # # # . # . # . # . # . . . # # # . . . . . . # . . # # . . . # # . # . # # . # # . . #
. # # . . . . . . . . . # . # . . # . . . . . . . # . # # . . . # . # # . . # # . # # # . . . # . #
. # . . . # # . # . # . # . . . . . . # . . # # # . . # # # . . . . . # . . . # . . . # . . # . . .
. . # # . . . . . . . . . . # . . # . # . . . # . . . . . # . . . # . . # # . . # # . . . . . . # .
# . # . . . . . . . # # # . . # . . . . . . . # # # . # # . . . . . . . . # . . # . . # . . . # . #
. # # # # # # . . . # . . . # . . . . . . . . . . . . # . . . . . . . . # . . . . . # . . # # . . .
# # # # . . # . . . # . . . # # . . . . . # # # . # . # . # # . . # . . # # # . . # . # . # . # # .
. . # # . . # # . . # # # # . # . # # . # . # . . # . . # # . . . . # . # . # . . # . # . # . . # .
. . # . . # . # # # . . . . . . . . . . . . . . . # . . . . # . # . . . # . # # . . # . # . # # . #
# . # . . # . # # . # . # . . . . . # # # . . . # # # # . # . . . . . . . . . # . # # # . . . # # .
. . . . # . # . # . . # . # . . . . # # # # . # . # # . # . . . . # . . # # . . . . # . . # . # . .
. # # . # . . # . . . # # . . . # # . # . # . # # # . . # . . . . # . . . # . . # # . . . . . # . #
# . . . . . # . . . # . # # . . # . # . . . . . . # . . . . . # . # . . . . . # . . # . . # . . . .
. . . # . # . # # . . . # . # . . . . # . # # # # # . . . # # . . . . . # . # . . # . . . . # . # .
. . # . # # . # . . # # . . . # . . . . . # . . # # . . . # # . # . . # . . . . # . # # . # . . . .
. . . . . # # . . . . # # . . # . . . . # . # # . . . . . # . . . . # # . . . . . # . . # # . . . .
. . . . # . . . # # # . . . . . . . . . . . . . . # # . # . . # # . # # . . . # . # . . . . . . # .
# # . . . # # # . . # . . . . # # . . . . # # # . . . . # . . . # # # . # . # . . . . . . . . # . .
. . . . . # # . # . . # # . . . # . # # . # . # . . . . # . . . . . . # # . . # . . . . # . # . # .
. . . # # . . . . . . . . . . . # # . . # . . # . . . . . . # . # . # # . # . # . # # . . # . # . .
# . # # # . # . . . # . . . . . . # # . . . . # . . # # . . # . # . . . . . . # . . . # . # . # # .
# # # . # . . . # # # . # . . . # . . . . # # . # . . . # . . . . # . . # . . . # . . . # . . # . .
# # . . . . . # . . # . # . # . . . . . . . . . . . # . . . . . # . . . . # # # . . . . . . . # . #
. . # # . . . . # . . # . . # . . # # . # . . . . . . # . . . . # # . # # # # # # # # . # # # # # .
. # . . . . . # . . # . . # . . . # . . # # . # # . . . . . . . . # # . . . . . . # # # # . . . . #
. . . . . . # . . . # . . . . # . # . . . # . . # . . . # # . # . # . # . . # # . # . . # . . # # #
# . . # . # . . # . # # . . . . # . . # # . . . . . # . . . . . . # . . . . # . # . . # . # # . . .
# . # . . # . . # . . . # # . . # . . . # . . . # . # . . . # . . . . # . . # # # . # # # # . # . .
. # . . . # . . . . # # . # # # . # . # . . . . . . . # . # . # . # . . . . . . . . . . # . . # . #
# . # . . . . . . . # . . # . . . # . . . # # . # . # # # . . . . . # # . . . . . . . . # # . . # .
. . # # # . . . # # . . . . . . # . # . . # . # # . . . . . . . . . . . . . # . . . . # . . # # . .
# # # # . # . # # # . # # . . # . . # . # # . # # # # . # . . . # . . # . . . # . # . . # . # . # #
. # . . . # . # . # . . . # . . . . . . . . # . . # . . # . # # . . . # . . . . . . . . # # . . . #
# . # . . . . . . # # . # # . . . . . # . # . # # . # . . # . . . . # . . . . . # # . . . # . . . #
. . . # # . # . # . . . . . # # # . # . . . . . # . . . # . . . # . . . . . # # # # . . . # # . . .
. # . . . . # . # . # . . . # # . . # # . # . . . # # # # . # # # . . # . . # # # # . # . . . . . #
. . # . . . # # . . . # # . . # # # . . . # . . # . . . # . . . . # # # . . . . # . . # . # # # . .
# . . . . . . . . . . # . # # . . # . . . . . # . . . . # . . # # # . . . # # . . . . . # # . . . #
# # . # . # . . . . # # # # # # . . . # # . . . # # . . . . . # . . # # . . . # . . # # . # . . . #
. # . . . . . . . . . # . . . . . # . # . . # # . . # # # . # . . . # # . . . # . . . # . . # . . #
# # . . . # . . . . # # . # . . . . # . . . . # # # . . . . # . # . . # . . . . . # . . . # . # . .
. # . . . # # # . . # # . . # . . . . # . . # # . . # . # # # # . . # . . . # . . . . . . # # # . #
# . . . . # . . . . . . . . . . # . . # # . . . . . . . # # . . # # . # # . . # . . . # . . . # # .
. # . # . . . . . . # . . # . . # # # # . # . # . . . . . . . . # . . . . . . . . . . . . . . # . #
. . # # # . # . . # . # . # . . . . . . # # . . . . # . # . # # . . . # # . . # # # . . . # . . . .
. # . . . . . . . . # . # . # # . # # # . . . . . # . # # # # # # . . . . . # . # # . . . . # . . #
. . . . . . . . # . . . . # . . # . . . . # # . . # . . # . . . # . . . . . . # . # # . . # # # . #
. # . . . . . # # # . . . . . . . . # . . . # . . # . . . . . . . # # . . # . # . # # . # . # # . .
