. . . # # . # . . . # . . . . # . . . . . . . . # . . # # . . # . . . . # . . .
# . . . . . . . . . # # # # # # . . . # . . . . . . # . # # # . # # . # # . . .
. . . . . # . . . . . . . # . . . # # . . . . . . . . . . # # . . . . . # # . #
. . . . # . # # # . . # # # . # . . # . . # . . . # . # . . . . . . # # . . # #
. . # . . . . . # . # . # # . . . . . . # . . . # . . . . . . . . # # # # . . .
# # . . . . . . . . . # . . # . . # # # . # . . # . . . # . . # # . # . # . . #
. . . . . # . # . # . # . # . # . . . . . . # # # . . # # . . . . # . # # . . #
# . # . # . . . # . . . # # . . # # # . # # . . # . # . . # . # # # # # # . . .
. . . . . . # # . # . # . . . # . . # . # . # . # . . . . . . # . . . . . # . .
# . . . # # . . . . # . # . # . . . # # # # . . . . . # . . # # # . . . . # . .
# . . . . # # . . # . . . # . . # . . . # . . . # . . . . . . . # . . . . # # .
# . . # . # # # # . . . . # # # . . # . . . # # # . . # . . . . . # # # . . . .
. # . . . . # . . # . # . . . . # . . # . . . . . # . . . . # . . . . . # . # #
# . . . # # . # # # # . . . . . . . # . # . . . # # . . # # . . # . . . . . . .
# . . . # # # # . # . . . . . . # . . . . . . . . . . . . . # . . . # # . . # .
. # . . . . . . . . # # . . . . # . # . # . # # # . . . # # . # # . # # # . # .
. . # # . . . . # # # . . . . # . # . . . . # . . . # # # . # . . # . # # # . #
# . . . . . # . . # # # . . . # . . . . . # . . # . # . . # . . . # . . # # . .
# . # # # . # . . # . # . # . . . # . . # # . # . . . . # . # # . # . . . . . .
. . . . . # . # . . # . . . . # . # . . # # # . . . # . . . . . . . # . # # . #
# . # . # . . . # . # . # . . . # . . . . . . . # . # # . # . # # # . . . # # #
. # . . . . . . . . . # # . . . # . . . . . . # . # # # # . # . . # . . . . # #
# # . . . # # . . . . # . . . # . # . . # . . . . # . . . . # # # . # . . # . .
. . . . . . . . # . . . # . # # . # . # . # # . # # # # . . . . . # # . # . . .
# . # # . # . . # # . . . . # . . . . . # # # . . # # . . . . . # . # # . # # .
. . # # # # . . # . # # . . . . . # . . . . . . # . . . # . . . . . . . # . . .
# # . # . . . . . . # . . . # # . . . # # . . . . . . . # # # . # # . # . . . .
# . . # . . . . # . . # . . . . # . . # . . # . . # # . . . . . . # # # # . # .
# . # # . . . . # . . . . # . . # . # # . . # . # . . . . # . . . . . . . . . .
# . . # . . . # . . # # # . . . . . . . # . . # . . . . . . . . . # # . . . # .
. . . . # . . . # . # . # # # . # . . . . . # . . . . # . . . # . . # . . . . .
. . . . . # . # # . . . # . . . . # # # . . . # . . . . # . # . # . . # # # # #
. . . # . . . . . . # # . . . # . # . # . . # # . # # # . . # . . . . . . # . #
# # . # . . # . . # . # . # . . . # # . # # . # . . # . # . . . . . . # . # . #
. # # . . . # # . . . # . # . . . # . . . . . . # . . . . . # . . . . . . . . #
. . # . . . # # . # . # . . . . . # . . . # . . . . # . # . . . . . . . # # . #
. . . # . . . . . . . . . . # . . # # # # . . . # . . . # # # . # . # # . # # .
# . # # . . # # # . . # . . . . # # # . # # # . . . # . . # . . # . # # . . . .
. . . . . . . # . . . . . # # . # # # # . # # # # . # # . . . . . . # # . . . .
. . # . . # # # # # . . . . . . . . . # . . . # # # . . # . # . # . . . . # . .
