. . # . . . . # . # . . . . . . # . . .
. . # . . . . . # . . . . # . # . . # .
. . . . . . . . . . . . . . . # . . # #
. . . . . . # . . . . . . . . # . # . .
. # . . . . . . . . . . # . . # # . . .
. . . . . . . . # # # . # . . . . . . .
. . . # . . . . . . # . # # . . . . . .
# # . . . . # . . . . . # . # . # # # .
. # . . . . # # . . # # . # . . . # . .
. . . . . # # . . . . . . # . . . # . .
. . . . . . . . . . . . . . . . . . . .
. . . . . . # . . . . . # . # # . . . .
. . . . . . . . . # . # . # . # . . . #
# # . . . . . . # . . . . . # . # # # .
# . . . . # . . # # # . . . . . . . . .
. # # # # # . . . . # . # . . . . . . .
. . . . # # . . . . . # . . . . . # . .
# . . . . . . # . # . # # . . . # . . .
. . . . . . # . . . . . . . . . . # . .
. . . . . . . . . # . # . . . # # . . .
