. . . . . . # . . .
# . . # . . . . # .
. . . . . . # . . #
. # . . . . . . . .
. . . # . . . . # .
. . . . . . . . . .
. # . . . . . . . #
# . . . . . . . . #
. . . . . . . . . .
# . . . . . # . # .
